.......7777
.......9...
..!....9...
.......9...
..!....9...
.......3...
..!....9...
.......9...
.......!...
.......9...
.......9...